{
	"level_image_pattern": "default",
	"level_pattern": [
	    [	-30, -30, -30, -30, -30, -30, -30, -30, -30, -30, -30, -30, -30, -30, -30, -30, -30, -30, -30, -30, -30, -30, -30, -30, -30, -30, -30, -30],
		[	 -8, -10, -10, -10, -10, -10, -10, -10, -10, -10, -10, -10, -10,  -7,  -8, -10, -10, -10, -10, -10, -10, -10, -10, -10, -10, -10, -10,  -7],
		[	 -9,   1,   1,   1,   1,   1,   1,   1,   1,   1,   1,   1,   1, -11,  -9,   1,   1,   1,   1,   1,   1,   1,   1,   1,   1,   1,   1, -11],
		[	 -9,   1, -15, -14, -14, -16,   1, -15, -14, -14, -14, -16,   1, -11,  -9,   1, -15, -14, -14, -14, -16,   1, -15, -14, -14, -16,   1, -11],
		[	 -9,   2, -11, -30, -30,  -9,   1, -11, -30, -30, -30,  -9,   1, -11,  -9,   1, -11, -30, -30, -30,  -9,   1, -11, -30, -30,  -9,   2, -11],
		[	 -9,   1, -12, -10, -10, -13,   1, -12, -10, -10, -10, -13,   1, -12, -13,   1, -12, -10, -10, -10, -13,   1, -12, -10, -10, -13,   1, -11],
		[	 -9,   1,   1,   1,   1,   1,   1,   1,   1,   1,   1,   1,   1,   1,   1,   1,   1,   1,   1,   1,   1,   1,   1,   1,   1,   1,   1, -11],
		[	 -9,   1, -15, -14, -14, -16,   1, -15, -16,   1, -15, -14, -14, -14, -14, -14, -14, -16,   1, -15, -16,   1, -15, -14, -14, -16,   1, -11],
		[	 -9,   1, -12, -10, -10, -13,   1, -11,  -9,   1, -12, -10, -10,  -7,  -8, -10, -10, -13,   1, -11,  -9,   1, -12, -10, -10, -13,   1, -11],
		[	 -9,   1,   1,   1,   1,   1,   1, -11,  -9,   1,   1,   1,   1, -11,  -9,   1,   1,   1,   1, -11,  -9,   1,   1,   1,   1,   1,   1, -11],
		[	-18, -14, -14, -14, -14, -16,   1, -11, -18, -14, -14, -16,   0, -11,  -9,   0, -15, -14, -14, -17,  -9,   1, -15, -14, -14, -14, -14, -17],
		[	-30, -30, -30, -30, -30,  -9,   1, -11,  -8, -10, -10, -13,   0, -12, -13,   0, -12, -10, -10,  -7,  -9,   1, -11, -30, -30, -30, -30, -30],
		[	-30, -30, -30, -30, -30,  -9,   1, -11,  -9,   0,   4,   0,   5,   0,   6,   0,   7,   0,   0, -11,  -9,   1, -11, -30, -30, -30, -30, -30],
		[	-30, -30, -30, -30, -30,  -9,   1, -11,  -9,   0, -15, -14, -14, -14, -14, -14, -14, -16,   0, -11,  -9,   1, -11, -30, -30, -30, -30, -30],
		[	-30, -30, -30, -30, -30,  -9,   1, -12, -13,   0, -11, -30, -30, -30, -30, -30, -30,  -9,   0, -12, -13,   1, -11, -30, -30, -30, -30, -30],
		[	-30, -30, -30, -30, -30,  -9,   1,   0,   0,   0, -11, -30, -30, -30, -30, -30, -30,  -9,   0,   0,   0,   1, -11, -30, -30, -30, -30, -30],
		[	-30, -30, -30, -30, -30,  -9,   1, -15, -16,   0, -11, -30, -30, -30, -30, -30, -30,  -9,   0, -15, -16,   1, -11, -30, -30, -30, -30, -30],
		[	-30, -30, -30, -30, -30,  -9,   1, -11,  -9,   0, -12, -10, -10, -10, -10, -10, -10, -13,   0, -11,  -9,   1, -11, -30, -30, -30, -30, -30],
		[	-30, -30, -30, -30, -30,  -9,   1, -11,  -9,   0,   0,   0,   0,   3,   0,   0,   0,   0,   0, -11,  -9,   1, -11, -30, -30, -30, -30, -30],
		[	-30, -30, -30, -30, -30,  -9,   1, -11,  -9,   0, -15, -14, -14, -14, -14, -14, -14, -16,   0, -11,  -9,   1, -11, -30, -30, -30, -30, -30],
		[	 -8, -10, -10, -10, -10, -13,   1, -12, -13,   0, -12, -10, -10,  -7,  -8, -10, -10, -13,   0, -12, -13,   1, -12, -10, -10, -10, -10,  -7],
		[	 -9,   1,   1,   1,   1,   1,   1,   1,   1,   1,   1,   1,   1, -11,  -9,   1,   1,   1,   1,   1,   1,   1,   1,   1,   1,   1,   1, -11],
		[	 -9,   1, -15, -14, -14, -16,   1, -15, -14, -14, -14, -16,   1, -11,  -9,   1, -15, -14, -14, -14,  -16,  1, -15, -14, -14, -16,   1, -11],
		[	 -9,   1, -12, -10,  -7,  -9,   1, -12, -10, -10, -10, -13,   1, -12, -13,   1, -12, -10, -10, -10,  -13,  1, -11,  -8, -10, -13,   1, -11],
		[	 -9,   2,   1,   1, -11,  -9,   1,   1,   1,   1,   1,   1,   1,   0,   0,   1,   1,   1,   1,   1,   1,   1, -11,  -9,   1,   1,   2, -11],
		[	-18, -14, -16,   1, -11,  -9,   1, -15, -16,   1, -15, -14, -14, -14, -14, -14, -14, -16,   1, -15, -16,   1, -11,  -9,   1, -15, -14, -17],
		[	 -8, -10, -13,   1, -12, -13,   1, -11,  -9,   1, -12, -10, -10,  -7,  -8, -10, -10, -13,   1, -11,  -9,   1, -12, -13,   1, -12, -10,  -7],
		[	 -9,   1,   1,   1,   1,   1,   1, -11,  -9,   1,   1,   1,   1, -11,  -9,   1,   1,   1,   1, -11,  -9,   1,   1,   1,   1,   1,   1, -11],
		[	 -9,   1, -15, -14, -14, -14, -14, -17, -18, -14, -14, -16,   1, -11,  -9,   1, -15, -14, -14, -17, -18, -14, -14, -14, -14, -16,   1, -11],
		[	 -9,   1, -12, -10, -10, -10, -10, -10, -10, -10, -10, -13,   1, -12, -13,   1, -12, -10, -10, -10, -10, -10, -10, -10, -10, -13,   1, -11],
		[	 -9,   1,   1,   1,   1,   1,   1,   1,   1,   1,   1,   1,   1,   1,   1,   1,   1,   1,   1,   1,   1,   1,   1,   1,   1,   1,   1, -11],
		[	-18, -14, -14, -14, -14, -14, -14, -14, -14, -14, -14, -14, -14, -14, -14, -14, -14, -14, -14, -14, -14, -14, -14, -14, -14, -14, -14, -17]		
	],
	"ghosts": ["red", "pink", "orange"]
}
